NO ./textures/minecraft/north.xpm
SO ./textures/wolfenstein/blue_stone.xpm
WE ./textures/minecraft/west.xpm
EA ./textures/wolfenstein/eagle.xpm

F 220, 100, 0
C 225, 30, 0

1
1
1
1
1

111111
10E0101
101001
11001
111111